1111111111111111111111111111111111111111114444
1111111111111111111111111111111111111111114444
11111111111111111111111111111111111111111144444444
11111111111111111111111111111111111111111144444444
11111111111111111111111111111111111111111111444444
11111111111111111111111111111111111141114411444444
11111111111111111111111111111111111111111141444444
11111111111111000000111101000011114111411444444444
11111111111000000000011000000000014114441141444441
11111111000000000000000000010000101144141444444444
11111110000002002002000000101000000111144414444144
11111110000000000000000000000000000000000000000000
111111100000000000000000000000000000000000000000000
11111110000002002002000000000000000000000000000000
11111111000000000000000110000000000111144444444444
11111111110010000111100000010001001141144144444444
11111111111110001111110000111000011441141444444444
11111111111111111111111111111111111114114444444444
11111111111111111111111111111111111141144144444444
11111111111111111111111111111111111111111144444444
11111111111111111111111111111111111111111144444444
11111111111111111111111111111111111111111144444444
11111111111111111111111111111111111111111144444444
11111111111111111111111111111111111111111144444444
