111111111111111111111111111111111111111111
111111111111111111111111111111111111111111
111111111111111111111111111111111111111111
111111111111111111111111111111111111111111
111111111111111111111111111111111111111111
111111111111111111111111111111111111111111
111111111111111111111111111111111111111111
111111111111111111111111111111111111111111
111111155557555557555555555555555551111111
111111155500000000055555555755555551111111
111111104000000000000555555555555551111111
111111100000000000000055555555557551111111
111111100000000000000005555555555551111111
111111100000000000000005555555555551111111
111111100000000000000005555555555551111111
111111100000000000000005555555555551111111
111111100000000000000005555555555551111111
111111100000000000000065555555557551111111
111111104000000000000655555555555551111111
111111166660000000066555555755555551111111
111111155556666666655555555555555551111111
111111155555555555555555555555555551111111
111111155555555555555555555555555551111111
111111111111111111111111111111111111111111
111111111111111111111111111111111111111111
111111111111111111111111111111111111111111
111111111111111111111111111111111111111111
111111111111111111111111111111111111111111
111111111111111111111111111111111111111111
111111111111111111111111111111111111111111
111111111111111111111111111111111111111111